BBEANS Tournament Arena
(-11, 11, 11, -11)
1.0
1.0
XX XX XX XX XX XX XX XX XX XX XX XX XX XX XX XX XX XX XX XX XX XX
XX 00 00 00 00 00 00 00 00 00 00 00 00 00 00 00 00 00 00 00 00 XX
XX 00 00 00 00 00 00 00 00 00 00 00 00 00 00 00 00 00 00 00 00 XX
XX 00 00 00 00 00 00 00 00 00 00 00 00 00 00 00 00 00 00 00 00 XX
XX 00 00 00 00 00 00 00 00 00 00 00 00 00 00 00 00 00 00 00 00 XX
XX 00 00 00 00 00 00 00 00 00 00 00 00 00 00 00 00 00 00 00 00 XX
XX 00 00 00 00 00 00 00 00 00 00 00 00 00 00 00 00 00 00 00 00 XX
XX 00 00 00 00 00 00 00 00 00 00 00 00 00 00 00 00 00 00 00 00 XX
XX 00 00 00 00 00 00 00 00 00 00 00 00 00 00 00 00 00 00 00 00 XX
XX 00 00 00 00 00 00 00 00 !! !! !! !! 00 00 00 00 00 00 00 00 XX
XX 00 00 00 00 00 00 00 00 !! !! !! !! 00 00 00 00 00 00 00 00 XX
XX 00 00 00 00 00 00 00 00 !! !! !! !! 00 00 00 00 00 00 00 00 XX
XX 00 00 00 00 00 00 00 00 !! !! !! !! 00 00 00 00 00 00 00 00 XX
XX 00 00 00 00 00 00 00 00 00 00 00 00 00 00 00 00 00 00 00 00 XX
XX 00 00 00 00 00 00 00 00 00 00 00 00 00 00 00 00 00 00 00 00 XX
XX 00 00 00 00 00 00 00 00 00 00 00 00 00 00 00 00 00 00 00 00 XX
XX 00 00 00 00 00 00 00 00 00 00 00 00 00 00 00 00 00 00 00 00 XX
XX 00 00 00 00 00 00 00 00 00 00 00 00 00 00 00 00 00 00 00 00 XX
XX 00 00 00 00 00 00 00 00 00 00 00 00 00 00 00 00 00 00 00 00 XX
XX 00 00 00 00 00 00 00 00 00 00 00 00 00 00 00 00 00 00 00 00 XX
XX 00 00 00 00 00 00 00 00 00 00 00 00 00 00 00 00 00 00 00 00 XX
XX XX XX XX XX XX XX XX XX XX XX XX XX XX XX XX XX XX XX XX XX XX